"provided","standard"
"W92000004",NA
"S92000003",NA
"N92000002",NA
"K02000001",NA
"E92000001",NA
