"provided","standard"
"E06000014","E06000014"
"E10000016","E10000016"
"E08000016","E08000016"
"E10000008","E10000008"
"E10000015","E10000015"
"E06000043","E06000043"
"E09000023","E09000023"
"E10000034","E10000034"
"E09000009","E09000009"
"E09000003","E09000003"
"E09000010","E09000010"
"E09000012","E09000012"
"E10000024","E10000024"
"E09000019","E09000019"
"E06000042","E06000042"
"E09000026","E09000026"
"E10000031","E10000031"
"E10000032","E10000032"
"E10000007","E10000007"
"E09000028","E09000028"
"E10000030","E10000030"
"E10000013","E10000013"
"E10000014","E10000014"
"E09000020","E09000020"
"E10000018","E10000018"
"E06000035","E06000035"
"E06000041","E06000041"
"E09000005","E09000005"
"E10000012","E10000012"
"E09000018","E09000018"
"E08000035","E08000035"
"E06000018","E06000018"
"E08000010","E08000010"
"E09000021","E09000021"
"E10000021","E10000021"
"E08000019","E08000019"
"E09000002","E09000002"
"E08000025","E08000025"
"E08000001","E08000001"
"E08000032","E08000032"
"E09000006","E09000006"
"E10000002","E10000002"
"E08000002","E08000002"
"E06000010","E06000010"
"E10000017","E10000017"
"E09000024","E09000024"
"E08000007","E08000007"
"E08000030","E08000030"
"E09000032","E09000032"
"E09000033","E09000033"
"E06000054","E06000054"
"E08000015","E08000015"
"E09000007","E09000007"
"E06000050","E06000050"
"E06000052","E06000052"
"E09000017","E09000017"
"E08000012","E08000012"
"E08000021","E08000021"
"E08000004","E08000004"
"E10000025","E10000025"
"E08000018","E08000018"
"E10000028","E10000028"
"E06000027","E06000027"
"E08000009","E08000009"
"E06000036","E06000036"
"E06000023","E06000023"
"E10000003","E10000003"
"E10000006","E10000006"
"E09000015","E09000015"
"E09000022","E09000022"
"E10000019","E10000019"
"E08000003","E08000003"
"E10000023","E10000023"
"E06000030","E06000030"
"E09000013","E09000013"
"E06000046","E06000046"
"E06000032","E06000032"
"E06000045","E06000045"
"E06000033","E06000033"
"E09000029","E09000029"
"E09000030","E09000030"
"E06000058","E06000058"
"E08000026","E08000026"
"E08000022","E08000022"
"E09000031","E09000031"
"E08000031","E08000031"
"W06000019","W06000019"
"W06000013","W06000013"
"W06000018","W06000018"
"W06000015","W06000015"
"W06000010","W06000010"
"W06000008","W06000008"
"W06000003","W06000003"
"W06000004","W06000004"
"W06000005","W06000005"
"W06000002","W06000002"
"W06000001","W06000001"
"W06000024","W06000024"
"W06000021","W06000021"
"W06000012","W06000012"
"W06000022","W06000022"
"W06000009","W06000009"
"W06000023","W06000023"
"W06000016","W06000016"
"W06000011","W06000011"
"W06000020","W06000020"
"W06000014","W06000014"
"W06000006","W06000006"
"E06000005","E06000005"
"E06000015","E06000015"
"E09000016","E09000016"
"E06000019","E06000019"
"E06000013","E06000013"
"E09000027","E09000027"
"E06000039","E06000039"
"E10000027","E10000027"
"E08000008","E08000008"
"E06000040","E06000040"
"E09000008","E09000008"
"E08000027","E08000027"
"E09000011","E09000011"
"E06000051","E06000051"
"E10000029","E10000029"
"E08000024","E08000024"
"E06000037","E06000037"
"S08000015","S08000015"
"S08000016","S08000016"
"S08000017","S08000017"
"S08000029","S08000029"
"S08000019","S08000019"
"S08000020","S08000020"
"S08000031","S08000031"
"S08000022","S08000022"
"S08000032","S08000032"
"S08000024","S08000024"
"S08000025","S08000025"
"S08000026","S08000026"
"S08000030","S08000030"
"S08000028","S08000028"
"E09000014","E09000014"
"E06000038","E06000038"
"E06000025","E06000025"
"E09000004","E09000004"
"E06000047","E06000047"
"E08000034","E08000034"
"E09000025","E09000025"
"E06000024","E06000024"
"E06000044","E06000044"
"E08000005","E08000005"
"E08000014","E08000014"
"E06000004","E06000004"
"E06000007","E06000007"
"E06000009","E06000009"
"E08000033","E08000033"
"E06000056","E06000056"
"E06000049","E06000049"
"E08000017","E08000017"
"E06000059","E06000059"
"E06000011","E06000011"
"E10000020","E10000020"
"E06000026","E06000026"
"E06000003","E06000003"
"E08000006","E08000006"
"E06000020","E06000020"
"E06000034","E06000034"
"E06000022","E06000022"
"E10000011","E10000011"
"E06000016","E06000016"
"E08000028","E08000028"
"E08000029","E08000029"
"E08000013","E08000013"
"E08000036","E08000036"
"E08000037","E08000037"
"E06000006","E06000006"
"E08000011","E08000011"
"E06000021","E06000021"
"E06000055","E06000055"
"E06000008","E06000008"
"E06000057","E06000057"
"E06000002","E06000002"
"E06000031","E06000031"
"E08000023","E08000023"
"E06000001","E06000001"
NA,NA
"E06000012","E06000012"
"W11000031","W11000031"
"W11000028","W11000028"
"W11000023","W11000023"
"W11000029","W11000029"
"W11000030","W11000030"
"W11000025","W11000025"
"W11000024","W11000024"
"E09000001","E09000001"
"E06000017","E06000017"
"N09000001","N09000001"
"N09000002","N09000002"
"N09000003","N09000003"
"N09000004","N09000004"
"N09000005","N09000005"
"N09000006","N09000006"
"N09000007","N09000007"
"N09000008","N09000008"
"N09000009","N09000009"
"N09000010","N09000010"
"N09000011","N09000011"
